1 CM017872.1
2 CM017873.1
3 CM017874.1
4 CM017875.1
5 CM017876.1
6 CM017877.1
7 CM017878.1
8 CM017879.1
9 CM017880.1
10 CM017881.1
11 CM017882.1
12 CM017883.1
13 CM017884.1
14 CM017885.1
15 CM017886.1
16 CM017887.1
